KꜸRACTA

<# CLASSIFYING
banli: x1 is great/grand in property x2 (ka) by standard x3
prenu: x1 is a person/people (noun) [not necessarily human]; x1 displays personality/a persona
simxu: x1 (set) has members who mutually/reciprocally x2 (event [x1 should be reflexive in 1+ sumti])
fasnu: x1 (event) is an event that happens/occurs/takes place; x1 is an incident/happening/occurrence       ⟦let's take fasnu as 'x1 is an occurence'. Magi! it became a ka!⟧

xagji: x1 hungers for x2; x1 needs/wants food/fuel x2
taske: x1 thirsts for x2; x1 needs/wants drink/fluid/lubrication x2
livla: x1 is a fuel/energy-source for powering x2 ⟦STA⟧
nitcu: x1 needs/requires/is dependent on/[wants] necessity x2 for purpose/action/stage of process x3
mukti: x1 (action/event/state) motivates/is a motive/incentive for action/event x2, per volition of x3


### scale markers
xadba: x1 is exactly/approximately half/semi-/demi-/hemi- of x2 by standard x3
mulno: x1 (event) is complete/done/finished; x1 (object) has become whole in property x2 by standard x3
milxe: x1 is mild/non-extreme/gentle/middling/somewhat in property x2 (ka); x1 is not very x2
mutce: x1 is much/extreme in property x2 (ka), towards x3 extreme/direction; x1 is, in x2, very x3
traji: x1 is superlative in property x2 (ka), the x3 extreme (ka; default ka zmadu) among set/range x4
ruble: x1 is weak/feeble/frail in property/quality/aspect x2 (ka) by standard x3


### SIBLINGS, SEXUAL, MARITAL, GENDER
dzena: x1 is an elder/ancestor of x2 by bond/tie/degree x3; x1's generation precedes x2's parents
cifnu: x1 is an infant/baby [helpless through youth/incomplete development] of species x2
jbena: x1 is born to x2 at time x3 [birthday] and place x4 [birthplace]; x1 is native to (fo) x4
tarbi: x1 is an embryo/zygote/fetus/fertilized egg with mother x2, and father x3
rirni: x1 is a parent of/raises/rears x2; x1 mentors/acts parental toward child/protege x2
rorci: x1 engenders/procreates/begets x2 with coparent x3

speni: x1 is married to x2; x1 is a spouse of x2 under law/custom/tradition/system/convention x3
tunba: x1 is a sibling of x2 by bond/tie/standard/parent(s) x3
lanzu: x1 (mass) is a family with members including x2 bonded/tied/joined according to standard x3

fetsi: x1 is a female/doe of species x2 evidencing feminine trait(s) x3 (ka); x1 is feminine
nakni: x1 is a male/buck of species x2 evidencing masculine trait(s) x3 (ka); x1 is masculine

ninmu: x1 is a woman/women; x1 is a female humanoid person [not necessarily adult]
nanmu: x1 is a man/men; x1 is a male humanoid person [not necessarily adult]

tamne: x1 is cousin to x2 by bond/tie x3; [non-immediate family member, default same generation]
famti: x1 is an aunt/uncle of x2 by bond/tie x3; x1 is an associated member of x2's parent's generation

mamta: x1 is a mother of x2; x1 bears/mothers/acts maternally toward x2; [not necessarily biological]
patfu: x1 is a father of x2; x1 begets/sires/acts paternal towards x2; [not necessarily biological]

panzi: x1 is a [biological] offspring/child/kid/hybrid of parent(s) x2; (adjective:) x1 is filial
bersa: x1 is a son of mother/father/parents x2 [not necessarily biological]
tixnu: x1 is a daughter of mother/father/parents x2; [not necessarily biological]

verba: x1 is a child/kid/juvenile [a young person] of age x2, immature by standard x3
nixli: x1 is a girl [young female person] of age x2 immature by standard x3
nanla: x1 is a boy/lad [young male person] of age x2 immature by standard x3

mensi: x1 is a sister of/sororal to x2 by bond/tie/standard/parent(s) x3; [not necessarily biological]
bruna: x1 is brother of/fraternal to x2 by bond/tie/standard/parent(s) x3; [not necess. biological]


<# K1
sb .
djacu: x1 is made of/contains/is a quantity/expanse of water; (adjective:) x1 is aqueous/[aquatic]
cikna: (adjective:) x1 is awake/alert/conscious
vifne: (adjective:) x1 is fresh/unspoiled
pruni: (adjective:) x1 is elastic/springy
cilce: (adjective:) x1 is wild/untamed
korcu: (adjective:) x1 is bent/crooked/not straight or direct/[twisted]/folded
sipna: x1 is asleep (adjective); x1 sleeps/is sleeping
fatci: x1 (du'u) is a fact/reality/truth/actuality, in the absolute
cando: x1 is idle/at rest/inactive
xutla: x1 is smooth/even/[soft/silky] in texture/regularity
vlile: x1 is an event/state/act of violence
rufsu: x1 is rough/coarse/uneven/[grainy/scabrous/rugged] in texture/regularity
rarna: x1 is natural/spontaneous/instinctive, not [consciously] caused by person(s)
mucti: x1 is immaterial/not physical/without material form
morsi: x1 is dead/has ceased to be alive
manku: x1 is dark/lacking in illumination
lunbe: x1 is bare/naked/nude; x1 is without cover/clothes/[protection]
pruxi: x1 is spiritual/pertains to the soul in nature [either energy or being]; x1 is ghostly/ethereal

cukla: x1 is round/circular [2-dimensional shape/form]; x1 is a disk/circle/ring

krixa: x1 cries out/yells/howls sound x2; x1 is a crier
cisma: x1 smiles/grins (facial expression)
frumu: x1 frowns/grimaces (facial expression)
senci: x1 sneezes [intransitive verb]
tunlo: x1 gulps/swallows
cmila: x1 laughs (emotional expression)
dacti: x1 is a material object enduring in space-time; x1 is a thing


### color .
skari: x1 is/appears to be of color/hue x2 as perceived/seen by x3 under conditions x4

crino: x1 is green/verdant [color adjective]
xunre: x1 is red/crimson/ruddy [color adjective]
nukni: x1 is magenta/fuchsia/purplish-red [color adjective]
narju: x1 is orange [color adjective]
pelxu: x1 is yellow/golden [color adjective]
cicna: x1 is cyan/turquoise/greenish-blue [color adjective]
blanu: x1 is blue [color adjective]
zirpu: x1 is purple/violet [color adjective]
bunre: x1 is brown/tan [color adjective]
blabi: x1 is white/very-light colored [color adjective]
grusi: x1 is gray [color adjective]
xekri: x1 is black/extremely dark-colored [color adjective]


### quantity .
snime: x1 is made of/contains/is a quantity/expanse of snow
nikle: x1 is made of/contains/is a quantity of nickel/other metal resistant to oxidation
margu: x1 is a quantity of/contains/made of mercury/quicksilver; [metaphor: fluid metal; temperature]
tabno: x1 is a quantity of/contains/is made of carbon/graphite/[diamond]/charcoal; x1 is organic
trano: x1 is a quantity of/contains/is made of nitrogen/ammonia/nitrates
cidro: x1 is a quantity of/contains/is made of hydrogen (H); [metaphor: light, flammable]
kijno: x1 is a quantity of/contains/is made of oxygen (O); [metaphor: supporting life/combustion]
sliri: x1 is a quantity of/contains/is made of sulfur/brimstone (S); [metaphor: foul odor, volcanic]
tunka: x1 is made of/contains/is a quantity of copper (Cu); [metaphor: reddish, electrical conductor]
zinki: x1 is a quantity of/contains/is made of zinc (Zn); [metaphor: hard metal]
solji: x1 is a quantity of/contains/is made of gold (Au); [metaphor: valuable, heavy, non-reactive]
tirse: x1 is a quantity of/contains/is made of iron (Fe); [metaphor: strong tarnishing]
tinci: x1 is a quantity of/contains/is made of tin (Sn); [metaphor: cheap or base metal]
rijno: x1 is made of/contains/is a quantity of silver/argentum (Ag); [metaphor: valuable, tarnishing]
cnisa: x1 is a quantity of/contains/is made of lead (Pb); [metaphor: heavy, malleable, soft metal]




<# K2
### ???
spofu: x1 is broken/inoperable/broken down/non-utile/not usable for function x2
maksi: x1 is magnetic [adjective] producing magnetic field x2
zanru: x1 approves of/gives favor to plan/action x2 (object/event)
sutra: x1 is fast/swift/quick/hastes/rapid at doing/being/bringing about x2 (event/state)
stali: x1 remains/stays at/abides/lasts with x2
ragve: x1 is located across/on the other side of gap/boundary x2 from x3; x1 is opposite (fi) x3 ⟦&KA⟧
nenri: x1 is in/inside/within x2; x1 is on the inside/interior of x2 [totally within the bounds of x2]
sraji: x1 is vertical/upright/erect/plump/oriented straight up and down in reference frame/gravity x2
sruri: x1 encircles/encloses/is surrounding x2 in direction(s)/dimension(s)/plane x3
sanli: x1 stands [is vertically oriented] on surface x2 supported by limbs/support/pedestal x3


### quantity . composition .
fagri: x1 is a fire/flame in fuel x2 burning-in/reacting-with oxidizer x3 (default air/oxygen)
fonmo: x1 is a quantity of foam/froth/suds of material x2, with bubbles/vacuoles of material x3

stasu: x1 is a quantity of soup/stew/olla/olio of ingredients including x2
bisli: x1 is a quantity of/is made of/contains ice [frozen crystal] of composition/material x2
blaci: x1 is a quantity of/is made of/contains glass of composition including x2
bratu: x1 is hail/sleet/freezing rain/solid precipitation of material/composition including x2
jinme: x1 is a quantity of/contains/is made of made of metal of composition including x2
gasta: x1 is a quantity of/is made of/contains steel of composition including x2
jilka: x1 is a quantity of/contains/is made of alkali/base of composition including x2
sodna: x1 is a quantity of/contains/is made of alkali metal of type x2 [default sodium]
romge: x1 is a highly reflective/polished non-tarnishing metallic surface, of metal x2 [often chromium]
navni: x1 is a quantity of/contains/is made of inert gas of type x2 [neon/argon/radon/xenon]
lastu: x1 is a quantity of/contains/is made of brass [copper/zinc alloy] of composition including x2
kliru: x1 is a quantity of/contains/is made of halogen of type x2 [chlorine, fluorine, iodine, etc.]
jikru: x1 is made of/contains/is a quantity of liquor/spirits distilled from x2
kliti: x1 is a quantity of/contains/is made of clay [moist, clammy dirt] of composition including x2
panje: x1 is a quantity of/contains/is made of sponge/porous material
mixre: x1 (mass) is a mixture/blend/colloid/commingling with ingredients including x2
matli: x1 is a quantity of/contains/is made of linen/flax [type of fabric/material]
slasi: x1 is a quantity of/is made of/contains plastic/polymer of type/component unit(s) x2
ransu: x1 is a quantity of/contains/is made of bronze of composition including x2
vanju: x1 is made of/contains/is a quantity of wine from fruit/grapes x2
salta: x1 (mass) is a quantity of salad [food] with ingredients/components including x2
lanbi: x1 is a quantity of protein/albumin of type x2 composed of amino acids (sequence/jo'u)
jduli: x1 is a quantity of jelly/semisolid [texture] of material/composition including x2
nanba: x1 is a quantity of/containing bread [leavened or unleavened] made from grains x2
pesxu: x1 is paste/pulp/dough/mash/mud/slurry [soft, smooth-textured, moist solid] of composition x2
sodva: x1 is made of/contains/is a quantity of a carbonated beverage of flavor/brand x2
slami: x1 is a quantity of/contains/is made of acid of composition x2; (adjective:) x1 is acidic

### quantity . source .
cirla: x1 is a quantity of/contains cheese/curd from source x2
ckafi: x1 is made of/contains/is a quantity of coffee from source/bean/grain x2
ctile: x1 is a quantity of petroleum/oil from source x2
danmo: x1 is made of/contains/is a quantity of smoke/smog/air pollution from source x2

### quantity . producer .
zgike: x1 is music performed/produced by x2 (event)
silka: x1 is a quantity of/contains/is made of silk produced by x2

### . standard .
jmive: x1 lives/is alive by standard x2; x1 is an organism/living thing
vrude: x1 is virtuous/saintly/[fine/moral/nice/holy/morally good] by standard x2
tilju: x1 is heavy/weighty in mass/weight by standard x2
racli: x1 (action/activity/behavior) is sane/rational by standard x2
plana: x1 is plump/fat/obese [excessively thick/bulbous/swollen] by standard x2
palci: x1 is evil/depraved/wicked [morally bad] by standard x2
nobli: x1 is noble/aristocratic/elite/high-born/titled in/under culture/society/standard x2
linto: x1 is light in mass/weight by standard x2
lerci: x1 (event) is late by standard x2
lenku: x1 is cold/cool by standard x2
kanro: x1 is healthy/fit/well/in good health by standard x2
juxre: x1 (action) is clumsy/awkward by standard x2
glare: x1 is hot/[warm] by standard x2
citno: x1 is young/youthful [relatively short in elapsed duration] by standard x2
clira: x1 (event) is early by standard x2
cafne: x1 (event) often/frequently/commonly/customarily occurs/recurs by standard x2
fenki: x1 (action/event) is crazy/insane/mad/frantic/in a frenzy (one sense) by standard x2

### ka . of .
mabla: x1 is a derogative connotation/sense of x2 used by x3; x3 derogates/'curses at' x2 in form x1
zabna: x1 is a favorable connotation/sense/way-of-looking-at x2 used by x3

vrusi: x1 (ka) is a taste/flavor of/emitted by x2; x2 tastes of/like x1
klina: x1 (object/media) is clear/transparent/without obstacle to in-the-clear x2 [transmission]
jinzi: x1 (property - ka) is an innate/inherent/intrinsic/natural property/quality/aspect of x2
tengu: x1 (property-ka) is a texture of x2
dimna: x1 is a fate/destiny of x2; [doom, curse are mabla-forms]; x2 is fated/predestined/doomed to x1

krati: x1 represents/is an agent/proxy/stands-in for [absent] x2 in matter(s)/function(s) x3
sevzi: x1 is a self/ego/id/identity-image of x2
kunti: x1 [container] is empty/vacant of x2 [material]; x1 is hollow
jadni: x1 (object) adorns/decorates x2; x1 is an adornment/decoration of x2; x2 is fancy/decorated
spisa: x1 [object/substance] is a piece/portion/lump/chunk/particle of x2 [substance]

balvi: x1 is in the future of/later than/after x2 in time sequence; x1 is latter; x2 is former
cabna: x1 is current at/in the present of/during/concurrent/simultaneous with x2 in time
purci: x1 is in the past of/earlier than/before x2 in time sequence; x1 is former; x2 is latter
funca: x1 (event/property) is determined by the luck/fortune of x2; (note mabla/zabna not implied)
srana: x1 pertains to/is germane/relevant to/concerns/is related/associated with/is about x2
sivni: x1 is private/personal/privy/[secret/confidential/confined] to x2; x1 is not-public/hidden
tcila: x1 is a detail/feature/particular of x2
kampu: x1 (property - ka) is common/general/universal among members of set x2 (complete set)

### cause . consequence .
raktu: x1 (event) troubles/disturbs x2 (person) causing problem(s) x3
tsapi: x1 is a seasoning/condiment/spice causing flavor/effect x2 (event/property)
fanza: x1 (event) annoys/irritates/bothers/distracts x2
culno: x1 is full/completely filled with x2
bartu: x1 is on the outside of x2; x1 is exterior to x2
daspo: x1 (event) destroys/ruins/wrecks/despoils x2; x1 is destructive

### consequence . cause .
fusra: x1 rots/decays/ferments with decay/fermentation agent x2; x1 is rotten/decayed/fermented
rutni: x1 is an artifact; x1 is artificial; x1 is made/caused by people/se kulnu x2; x1 is man-made

### . locus .
kinli: x1 is sharp/keen at locus x2
jinru: x1 (object/person) is immersed/submerged/bathes in liquid x2
fulta: x1 (passive) floats on/in fluid (gas/liquid) x2; x1 is buoyant
febvi: x1 boils/evaporates at temperature x2 and pressure x3
jelca: x1 burns/[ignites/is flammable/inflammable] at temperature x2 in atmosphere x3
zutse: x1 sits [assumes sitting position] on surface x2
vreta: x1 lies/rests/reclines/reposes on x2; x1 is reclining/recumbent/lying on x2
zvati: x1 (object/event) is at/attending/present at x2 (event/location)
stuzi: x1 is an inherent/inalienable site/place/position/situation/spot/location of x2 (object/event)
sakli: x1 slides/slips/glides on x2
nurma: x1 is a rural/rustic/pastoral area of x2; x1 is in the country ⟦WHY LIMITATION TO SPACE⟧
cinje: x1 is a wrinkle/crease/fold [shape/form] in x2

### . conditions .
lakne: x1 (event/state/property) is probable/likely under conditions x2
viknu: x1 is thick/viscous under conditions x2
cumki: x1 (event/state/property) is possible under conditions x2; x1 may/might occur; x1 is a maybe
jitfa: x1 (du'u) is false/is an untruth by standard/epistemology/metaphysics x2
jetnu: x1 (du'u) is true/truth by standard/epistemology/metaphysics x2

### . ka .
darsi: x1 shows audacity/chutzpah in behavior x2 (event/activity); x1 dares to do/be x2 (event/ka)
cumla: x1 is humble/modest about x2 (abstraction); x1 displays humility about x2
curve: x1 is pure/unadulterated/unmitigated/simple in property x2 (ka)
bebna: x1 is foolish/silly in event/action/property [folly] (ka) x2; x1 is a boob
nutli: x1 is neutral/not taking sides/medial/not towards any extreme on scale/in dissension x2
prane: x1 is perfect/ideal/archetypical/faultless/flawless/un-improvable in property/aspect x2 (ka)
pindi: x1 is poor/indigent/scanty/impoverished/lacking in goods/possessions/property x2
manfo: x1 (object/event) is uniform/homogeneous in property x2 (ka)
makcu: x1 is mature/ripe/fully-grown/adult in development-quality x2 (ka)
kalsa: x1 is chaotic/disordered in property/aspect x2 (ka)
vrici: x1 (set/mass/ind.) is miscellaneous/various/assorted in property x2 (ka)
vitci: x1 is irregular/occasional/intermittent in property/action/aspect x2
sampu: x1 is simple/unmixed/uncomplicated in property x2 (ka)
ricfu: x1 is rich/wealthy in goods/possessions/property/aspect x2
ralci: x1 is delicate/fragile/subtle/refined in property x2 (ka)
kantu: x1 is a quantum/ray/elementary particle/smallest measurable increment of property/activity x2
claxu: x1 is without/lacking/free of/lacks x2; x1 is x2-less
cnici: x1 is orderly/neat/ordered in property/quantity x2 (ka/ni)
trati: x1 is taut/tense/strained tight in direction x2

### . observered by/base .
makfa: x1 is magic/supernatural/sorcery/witchcraft/wizardry to x2, performed by person/force/deity x3
zasti: x1 exists/is real/actual/reality for x2 under metaphysics x3

censa: x1 is holy/sacred to person/people/culture/religion/cult/group x2
cidja: x1 is food/feed/nutriment for x2; x1 is edible/gives nutrition to x2
betri: x1 is a tragedy/disaster/tragic for x2
jursa: x1 (event/action/state) is severe/harsh to x2 [victim/experiencer]
xenru: x1 regrets/rues (abstraction) x2; x1 is regretful/rueful/sorry/[remorseful] about x2
zekri: x1 (event/state) is a punishable crime/[taboo/sin] to people/culture/judges/jury x2
vindu: x1 is poisonous/venomous/toxic/a toxin to x2
titla: x1 is sweet/sugary/saccharine to observer x2
slari: x1 is sour/tart to observer x2
xanri: x1 [concept] exists in the imagination of/is imagined by/is imaginary to x2
ferti: x1 is fertile/conducive for supporting the growth/development of x2; x1 is fruitful/prolific
spaji: x1 (event/action abstract) surprises/startles/is unexpected [and generally sudden] to x2
snuti: x1 (event/state) is an accident/unintentional on the part of x2; x1 is an accident
misno: x1 (person/object/event) is famous/renowned/is a celebrity among community of persons x2 (mass)
gubni: x1 is public/un-hidden/open/jointly available to/owned by all among community x2 (mass)

### . experiences/anticipates .
cpina: x1 is pungent/piquant/peppery/spicy to sense x2
bredi: x1 is ready/prepared for x2 (event)
birti: x1 is certain/sure/positive/convinced that x2 is true
dirba: x1 is dear/precious/darling to x2; x1 is emotionally valued by x2
surla: x1 relaxes/rests/is at ease in/by doing/being x2 (activity)
kucli: x1 is curious/wonders about/is interested in/[inquisitive about] x2 (object/abstract)
gleki: x1 is happy/gay/merry/glad/gleeful about x2 (event/state)
masno: x1 is slow/sluggish at doing/being/bringing about x2 (event/state)
lazni: x1 (person) is lazy/avoiding work/effort concerning action x2
junri: x1 (person) is serious/earnest/has gravity about x2 (event/state/activity)
jundi: x1 is attentive towards/attends/tends/pays attention to object/affair x2
fliba: x1 fails at doing x2 (state/event); x1 is a failure at its role in x2
prami: x1 loves/feels strong affectionate devotion towards x2 (object/state)
nelci: x1 is fond of/likes/has a taste for x2 (object/state)
kusru: x1 (person) is cruel/mean/unkind to victim x2
kurji: x1 takes-care-of/looks after/attends to/provides for/is caretaker for x2 (object/event/person)
pajni: x1 judges/referees/arbitrates/is a judge determining/deciding matter x2 (abstract) ⟦with {sakli}, for STA vs DYN⟧
manci: x1 feels wonder/awe/marvels about x2
kufra: x1 feels comfort/is comfortable with conditions/environmental property(ies) x2
jgira: x1 (person) feels/has pride in/about x2 (abstraction)
zungi: x1 feels guilt/remorse about x2 (abstraction)
xalbo: x1 uses levity/is non-serious/frivolous about x2 (abstraction)
sutra: x1 is fast/swift/quick/hastes/rapid at doing/being/bringing about x2 (event/state)
steba: x1 feels frustration about x2 (abstraction)
senpi: x1 doubts/is dubious/doubtful/skeptical/questions that x2 (du'u) is true
sanji: x1 is conscious/aware of x2 (object/abstract); x1 discerns/recognizes x2 (object/abstract)
stati: x1 has a talent/aptitude/innate skill for doing/being x2
xalni: x1 (person) is panicked by crisis x2 (event/state)
badri: x1 is sad/depressed/dejected/[unhappy/feels sorrow/grief] about x2 (abstraction)
burna: x1 is embarrassed/disconcerted/flustered/ill-at-ease about/under conditions x2 (abstraction)
dunku: x1 is anguished/distressed/emotionally wrought/stressed by x2
xebni: x1 hates/despises x2 (object/abstraction); x1 is full of hate for x2; x2 is odious to x1
senva: x1 dreams about/that x2 (fact/idea/event/state); x2 is a dream/reverie of x1
terpa: x1 fears x2; x1 is afraid/scared/frightened by/fearful of x2 (event/tu'a object)
tatpi: x1 is tired/fatigued by effort/situation x2 (event); x1 needs/wants rest
pendo: x1 is/acts as a friend of/to x2 (experiencer); x2 befriends x1
panpi: x1 is at peace with x2
jikca: x1 interacts/behaves socially with x2; x1 socializes with/is sociable towards x2
tunta: x1 (object, usually pointed) pokes/jabs/stabs/prods x2 (experiencer)
sraku: x1 [abrasive/cutting/scratching object/implement] scratches/[carves]/erodes/cuts [into] x2
sinma: x1 esteems/respects/venerates/highly regards x2 [object of respect]
kurki: x1 is bitter/acrid/sharply disagreeable to observer/sense x2
cinri: x1 (abstraction) interests/is interesting to x2; x2 is interested in x1
snura: x1 is secure/safe from threat x2 (event)
tisna: x1 (object) fills/becomes stuffed [up]/inflates/blows up with material x2; x2 pours into x1

### . composition .
gunma: x1 is a mass/team/aggregate/whole, together composed of components x2, considered jointly
clupa: x1 is a loop/circuit of x2 [material]
cilmo: x1 is moist/wet/damp with liquid x2
bumru: x1 is foggy/misty/covered by a fog/mist/vapor of liquid x2
skori: x1 is cord/cable/rope/line/twine/cordage/woven strands of material x2
birje: x1 is made of/contains/is a amount of beer/ale/brew brewed from x2
bukpu: x1 is an amount of cloth/fabric of type/material x2
cfine: x1 is a wedge [shape/form/tool] of material x2
cilta: x1 is a thread/filament/wire [shape/form] of material x2
creka: x1 is a shirt/blouse/top [upper-body garment - not necessarily sleeved or buttoned], material x2
jesni: x1 is a needle [pointed shape/form, not tool] of material x2
jbama: x1 is a bomb/explosive device with explosive material/principle x2
sudga: x1 is dry of liquid x2; (adjective:) x1 is arid
foldi: x1 is a field [shape/form] of material x2; x1 is a broad uniform expanse of x2
dasri: x1 is a ribbon/tape/strip/band/stripe of material x2
&mixre: x1 (mass) is a mixture / blend / colloid / commingling with ingredients including x2.
smoka: x1 is a sock/stocking [flexible foot and lower leg garment] of material x2
skaci: x1 is a skirt/kilt/dress of material x2; x1 is skirted [garment open at the bottom; not legged]
sacki: x1 is a match [incendiary device] made of x2
palta: x1 is a plate/dish/platter/saucer [flat/mildly concave food service bed] made of material x2
pastu: x1 is a robe/tunic/gown/cloak/dress/[coveralls] [a long/full body garment] of material x2
palku: x1 are pants/trousers/slacks/leggings [legged garment] of material x2
mapku: x1 is a cap/hat/crown/helmet/piece of headgear [head-top garment] of material x2
kosta: x1 is a coat/jacket/sweater/cloak/[cape/shawl/pullover] [extra outer garment] of material x2
kamju: x1 is a column/pillar of material x2
matci: x1 is a mat/pad/mattress/pallet [flat, soft, dense form] of material x2
grana: x1 is a rod/pole/staff/stick/cane [shape/form] of material x2
gluta: x1 is a mitten/glove [hand and lower arm garment] of material x2
genxu: x1 is a hook/crook [shape/form] of material x2
fenra: x1 is a crack/fissure/pass/cleft/ravine/chasm/[defect/flaw] [shape/form] in x2



<# K3
### ???
simsa: x1 is similar/parallel to x2 in property/quantity x3 (ka/ni); x1 looks/appears like x2
prali: x1 is a profit/gain/benefit/advantage to x2 accruing/resulting from activity/process x3
fuzme: x1 is responsible/accountable for x2 (action/resulting state) to judge/authority x3
drata: x1 isn't the-same-thing-as/is different-from/other-than x2 by standard x3; x1 is something else
dukse: x1 is an excess of/too much of x2 by standard x3
dukti: x1 is polar opposite from/contrary to x2 in property/on scale x3 (property/si'o)
dunja: x1 freezes/jells/solidifies at temperature x2 and pressure x3
diklo: x1 is local to x2; x1 is confined to locus x2 within range x3
dikni: x1 is regular/cyclical/periodic in property (ka)/activity x2 with period/interval x3
denmi: x1 is dense/concentrated/packed/intense in property x2 (ka) at location/locus x3
darno: x1 is far/distant from x2 in property x3 (ka)
cunso: x1 is random/fortuitous/unpredictable under conditions x2, with probability distribution x3
ctino: x1 is a shadow/the shade of object x2, made by light/energy source x3
cmalu: x1 is small in property/dimension(s) x2 (ka) as compared with standard/norm x3
clani: x1 is long in dimension/direction x2 (default longest dimens.) by meas. stand. x3
cladu: x1 is loud/noisy at observation point x2 by standard x3
ckape: x1 is perilous/dangerous/potentially harmful to x2 under conditions x3
ckaji: x1 has/is characterized by property/feature/trait/aspect/dimension x2 (ka); x2 is manifest in x3
clite: x1 is polite/courteous/civil in matter x2 according to standard/custom x3
cinla: x1 is thin in direction/dimension x2 by standard x3; [relatively short in smallest dimension]
cimde: x1 (property - ka) is a dimension of space/object x2 according to rules/model x3
cimni: x1 is infinite/unending/eternal in property/dimension x2, to degree x3 (quantity)/of type x3
basti: x1 replaces/substitutes for/instead of x2 in circumstance x3; x1 is a replacement/substitute
banzu: x1 (object) suffices/is enough/sufficient for purpose x2 under conditions x3
barda: x1 is big/large in property/dimension(s) x2 (ka) as compared with standard/norm x3
bilga: x1 is bound/obliged to/has the duty to do/be x2 in/by standard/agreement x3; x1 must do x2
bradi: x1 is an enemy/opponent/adversary/foe of x2 in struggle x3
bilma: x1 is ill/sick/diseased with symptoms x2 from disease x3
carmi: x1 is intense/bright/saturated/brilliant in property (ka) x2 as received/measured by observer x3
catni: x1 has authority/is an official in/on/over matter/sphere/persons x2 derived on basis x3
certu: x1 is an expert/pro/has prowess in/is skilled at x2 (event/activity) by standard x3
bargu: x1 arches/curves over/around x2 and is made of x3; x1 is an arch over/around x2 of material x3
cevni: x1 is a/the god/deity of people(s)/religion x2 with dominion over x3 [sphere]; x1 is divine
cfipu: x1 (event/state) confuses/baffles x2 [observer] due to [confusing] property x3 (ka)
cfila: x1 (property - ka) is a flaw/fault/defect in x2 causing x3
citri: x1 is a history of x2 according to x3 (person)/from point-of-view x3
cizra: x1 is strange/weird/deviant/bizarre/odd to x2 in property x3 (ka)
kluza: x1 (obj.) is loose/bloused/not tight on x2 (obj.) at locus x3
smaji: x1 (source) is quiet/silent/[still] at observation point x2 by standard x3
prije: x1 is wise/sage about matter x2 (abstraction) to observer x3
kukte: x1 is delicious/tasty/delightful to observer/sense x2 [person, or sensory activity]
kandi: x1 is dim/dull/pale/non-intense in property x2 (ka) as received/measured by observer x3
junta: x1 is the weight of object x2 in [gravitational or other force] field x3
jdari: x1 is firm/hard/resistant/unyielding to force x2 under conditions x3
suksa: x1 (event/state) is sudden/sharply changes at stage/point x2 in process/property/function x3
ranti: x1 is soft/malleable/moldable/yielding to force x2 in conditions x3
satci: x1 [measurement/match] is exact/precise to precision x2 in property/quantity x3 (ka/ni)
sarxe: x1 is harmonious/concordant/in agreement/concord with x2 in property x3 (ka)






### sb . locus . ka .
fatri: x1 is distributed/allotted/allocated/shared among x2 with shares/portions x3; (x2/x3 fa'u)

### . logically . under logic system .
nibli: x1 logically necessitates/entails/implies action/event/state x2 under rules/logic system x3
natfe: x1 (du'u) contradicts/denies/refutes/negates x2 (du'u) under rules/logic x3

### sb . displays,interacts to,with sb . reason/motive/ka/about .
kecti: x1 (person) pities/feels sorry for x2 (person) about x3 (abstraction)
fengu: x1 is angry/mad at x2 for x3 (action/state/property)
xarnu: x1 is stubborn/willfully opposing/resisting x2 about x3 (event/state)
zunti: x1 (evt./state) interferes with/hinders/disrupts x2 (evt./state/process) due to quality x3 (ka)
tcica: x1 (event/experience) misleads/deceives/dupes/fools/cheats/tricks x2 into x3 (event/state)
mapti: x1 fits/matches/suits/is compatible/appropriate/corresponds to/with x2 in property/aspect x3
mansa: x1 satisfies evaluator x2 in property (ka)/state x3
jilra: x1 (person) is jealous of/envies x2 (person) about/for x3 (property - ka)
jibni: x1 is near/close to/approximates x2 in property/quantity x3 (ka/ni)
jbini: x1 is between/among set of points/bounds/limits x2 (set)/amidst mass x2 in property x3 (ka)
frica: x1 differs/is distinct from/contrasts with/is unlike x2 in property/dimension/quantity x3
xendo: x1 (person) is kind to x2 in actions/behavior x3
trina: x1 attracts/appeals to/lures x2 (person/event) with property/quality x3 (ka)
talsa: x1 (person) challenges x2 at/in property x3
stace: x1 is honest/open/truthfully revealing to/candid/frank with x2 about matter/fact x3
sidju: x1 helps/assists/aids object/person x2 do/achieve/maintain event/activity x3
selfu: x1 (agent) serves x2 with service x3 (activity); x1 is a servant [noun] of x2 performing x3
fapro: x1 opposes/balances/contends against opponent(s) x2 (person/force ind./mass) about x3 (abstract)
kansa: x1 is with/accompanies/is a companion of x2, in state/condition/enterprise x3 (event/state)
tirna: x1 hears x2 against background/noise x3; x2 is audible; (adjective:) x1 is aural

### sb . ka . from .
xalka: x1 is a quantity of/contains/is made of alcohol of type x2 from source/process x3

### su'u . for . standard .
kargu: x1 (object/commodity/property/event) is costly/expensive/dear to x2 by standard x3
xlali: x1 is bad for x2 by standard x3; x1 is poor/unacceptable to x2
xamgu: x1 (object/event) is good/beneficial/nice/[acceptable] for x2 by standard x3

### . is su'u . standard .
pluja: x1 is complex/complicated/involved in aspect/property x2 (ka) by standard x3
jinsa: x1 (object) is clean/pure of material/contaminant/dirt x2 by standard x3
ganra: x1 is broad/wide in dimension x2 [2nd most significant dimension] by standard x3
zasni: x1 is temporary/not permanent/expected to change in property x2 (ka) by standard/expectant x3
vitno: x1 is permanent/lasting/[eternal] in property x2 (ka) by standard x3 [time-span/expectant one]
tsali: x1 is strong/powerful/[tough] in property/quality x2 (ka) by standard x3
virnu: x1 is brave/valiant/courageous in activity x2 (event) by standard x3

### su'u . sb . in ka .
fange: x1 is alien/foreign/[exotic]/unfamiliar to x2 in property x3 (ka)
zdile: x1 (abstract) is amusing/entertaining to x2 in property/aspect x3; x3 is what amuses x2 about x
xajmi: x1 is funny/comical to x2 in property/aspect x3 (nu/ka); x3 is what is funny about x1 to x2
vajni: x1 (object/event) is important/significant to x2 (person/event) in aspect/for reason x3 (nu/ka)
ranxi: x1 is ironic(al)/contrary to expectation x2 in state/property/aspect x3
ralju: x1 is principal/chief/leader/main/[staple], most significant among x2 (set) in property x3 (ka)

### content . sb . condition .
pluka: x1 (event/state) seems pleasant to/pleases x2 under conditions x3
macnu: x1 (event/action/process) is manual [not automatic] in function x2 under conditions x3
zifre: x1 is free/at liberty to do/be x2 (event/state) under conditions x3
xanka: x1 is nervous/anxious about x2 (abstraction) under conditions x3
vlipa: x1 has the power to bring about x2 under conditions x3; x1 is powerful in aspect x2 under x3
stodi: x1 is constant/invariant/unchanging in property x2 (ka) in response to stimulus/conditions x3
zmiku: x1 is automatic in function x2 under conditions x3
sarcu: x1 (abstract) is necessary/required for continuing state/process x2 under conditions x3
nandu: x1 is difficult/hard/challenging for x2 under conditions x3; x1 challenges (non-agentive) x2
frili: x1 (action) is easy/simple/facile for x2 (agent) under conditions x3; x2 does x1 freely/easily
tcaci: x1 is a custom/habit/[ritual/rut] of x2 under conditions x3
rigni: x1 is repugnant to/causes disgust to x2 under conditions x3
sarcu: x1 (abstract) is necessary/required for continuing state/process x2 under conditions x3

### ka . from . via
sucta: x1 (si'o) is abstracted/generalized/idealized from x2 [something concrete] by rules x3

### ka . sb . locus .
steci: x1 (ka) is specific/particular/specialized/[special]/a defining property of x2 among x3 (set)
mupli: x1 is an example/sample/specimen/instance/case/illustration of common property(s) x2 of set x3

### content . ka . locus .
fadni: x1 [member] is ordinary/common/typical/usual in property x2 (ka) among members of x3 (set)
rirci: x1 [member] is rare/unusual/uncommon/atypical in property x2 (ka) among members of x3 (set)

### . is to the of . spatial frame of reference .
pinta: x1 is flat/level/horizontal in gravity/frame of reference x2

zunle: x1 is to the left/left-hand side of x2 which faces/in-frame-of-reference x3
pritu: x1 is to the right/right-hand side of x2 which faces/in-frame-of-reference x3

berti: x1 is to the north/northern side [right-hand-rule pole] of x2 according to frame of reference x3
snanu: x1 is to the south/southern side of x2 according to frame of reference x3
stuna: x1 is to the east/eastern side of x2 according to frame of reference x3
stici: x1 is to the west/western side of x2 according to frame of reference x3

crane: x1 is anterior/ahead/forward/(in/on) the front of x2 which faces/in-frame-of-reference x3
trixe: x1 is posterior/behind/back/in the rear of x2 which faces/in-frame-of-reference x3

gapru: x1 is directly/vertically above/upwards-from x2 in gravity/frame of reference x3
cnita: x1 is directly/vertically beneath/below/under/underneath/down from x2 in frame of reference x3

galtu: x1 is high/up/upward in frame of reference x2 as compared with baseline/standard height x3
dizlo: x1 is low/down/downward in frame of reference x2 as compared with baseline/standard height x3

mlana: x1 is to the side of/lateral to x2 and facing x3 from point of view/in-frame-of-reference x4
jvinu: x1 is the view/scene/panorama/sight/prospect of x2 (object/location) from point-of-view x3
farna: x1 is the direction of x2 (object/event) from origin/in frame of reference x3
cpana: x1 is upon/atop/resting on/lying on [the upper surface of] x2 in frame of reference/gravity x3
salpo: x1 is sloped/inclined/slanted/aslant with angle x2 to horizon/frame x3

### . is (comparative) than . ka . amount .
mleca: x1 is less than x2 in property/quantity x3 (ka/ni) by amount x4
zmadu: x1 exceeds/is more than x2 in property/quantity x3 (ka/ni) by amount/excess x4
bancu: x1 exceeds/is beyond limit/boundary x2 from x3 in property/amount x4 (ka/ni)

### . is in dimension/direction . standard .
tordu: x1 is short in dimension/direction x2 [default longest dimens.] by meas. stand. x3
rotsu: x1 is thick in dimension/direction x2 by standard x3; [relatively long in smallest dimension]
jarki: x1 is narrow in dimension x2 [2nd most significant dimension] by standard x3

### quantity . source . composition/from .
sligu: x1 is solid, of composition/material including x2, under conditions x3
krili: x1 is a quantity of/contains/is made of crystal of composition x2 in form/arrangement x3
staku: x1 is a quantity of/contains/is made of ceramic made by x2, of composition x3, in form/shape x4
xinmo: x1 is a quantity of ink of color/pigment x2 used by writing device x3

bakri: x1 is a quantity of/contains/is made of chalk from source x2 in form x3
canre: x1 is a quantity of/contains/is made of sand/grit from source x2 of composition including x3
ckabu: x1 is a quantity of/contains/is made of rubber/latex from source x2 of composition including x3
dertu: x1 is a quantity of/contains/is made of dirt/soil/earth/ground from source x2 of composition x3
matne: x1 is a quantity of/contains butter/oleo/margarine/shortening from source x2
lakse: x1 is quantity of wax [substance especially soft/moldable when warm] from source x2
ladru: x1 is made of/contains/is a quantity of milk from source x2; (adjective:) x1 is lactic/dairy
jisra: x1 is made of/contains/is a quantity of juice/nectar from-source/of-type x2
jemna: x1 is a gem/polished stone/pearl of type x2 from gemstone/material/source x3
jalna: x1 is a quantity of/contains/is made of starch from source x2 of composition including x3
zbabu: x1 is a quantity of/contains/is made of soap from source x2 of composition including x3
tarla: x1 is a quantity of/contains/is made of tar/asphalt from source x2
silna: x1 is a portion/quantity of salt from source x2, of composition including x3
sakta: x1 is made of/contains/is a quantity of sugar [sweet edible] from source x2 of composition x3
†rokci: x1 is a quantity of/is made of/contains rock/stone of type/composition x2 from location x3
†kunra: x1 is/contains/is made from a mineral/ore of type/metal x2 mined from location/lode/mine x3
†jinto: x1 is a well/spring of fluid x2 at location x3
kruji: x1 is made of/contains/is a quantity of cream/emulsion/puree [consistency] of composition x2
kolme: x1 is a quantity of/contains/is made of coal/peat/anthracite/bituminous from source x2

## . is . unit standard .
†mitre: x1 is x2 meter(s) [metric] in length (default is 1) measured in direction x3 by standard x4
†minli: x1 is x2 (defaults 1) long local distance unit(s) [non-metric], x3 subunits, standard x4
bunda: x1 is x2 (def. 1) local weight unit(s) [non-metric], standard x3, subunits [e.g. ounces] x4
dekpu: x1 is x2 (defaults 1) local volume unit(s) [non-metric; e.g. bushel], standard x3, x4 subunits
gradu: x1 [magnitude] is a unit/degree of/on scale/reference standard x2 (si'o) measuring property x3

snidu: x1 is x2 seconds in duration (default is 1 second) by standard x3
mentu: x1 is x2 minutes in duration (default is 1 minute) by standard x3
cacra: x1 is x2 hours in duration (default is 1 hour) by standard x3
djedi: x1 is x2 full days in duration (default is 1 day) by standard x3; (adjective:) x1 is diurnal
jeftu: x1 is x2 weeks in duration (default is 1 week) by standard x3
masti: x1 is x2 months in duration [default is 1 month] by month standard x3
nanca: x1 is x2 years in duration (default is 1 year) by standard x3; (adjective:) x1 is annual
xampo: x1 is x2 ampere(s) [metric] in current (default is 1) by standard x3
stero: x1 is x2 steradian(s) [metric] in solid angle (default is 1) by standard x3
radno: x1 is x2 radian(s) [metric] in angular measure (default is 1) by standard x3
molro: x1 is x2 mole(s) [metric] in substance (default is 1) by standard x3
litce: x1 is x2 liter(s) [metric] in volume (default is 1) by standard x3
kramu: x1 is x2 local area unit(s) [non-metric] (default 1) by standard x3, x4 subunits
kelvo: x1 is x2 degree(s) Kelvin [metric] in temperature (default is 1) by standard x3
gutci: x1 is x2 (defaults 1) short local distance unit(s) [non-metric], standard x3, x4 subunits
grake: x1 is x2 gram(s) [metric] in mass (default is 1) by standard x3
delno: x1 is x2 candela [metric] in luminosity (default is 1) by standard x3

fepni: x1 is measured in kopeck/cent money-subunits as x2 [quantity], in monetary system x3
rupnu: x1 is measured in major-money-units (dollar/yuan/ruble) as x2 (quantity), monetary system x3



<# K4
simlu: x1 seems/appears to have property(ies) x2 to observer x3 under conditions x4
panra: x1 parallels x2 differing only in property x3 (ka; jo'u/fa'u term) by standard/geometry x4
vamji: x1 (ni) is the equivalent value/worth of x2 [item(s) of value] to x3 for use/appreciation x4
drani: x1 is correct/proper/right/perfect in property/aspect x2 (ka) in situation x3 by standard x4
cinse: x1 in activity/state x2 exhibits sexuality/gender/sexual orientation x3 (ka) by standard x4
cnino: x1 is new/unfamiliar/novel to observer x2 in feature x3 (ka) by standard x4; x1 is a novelty
cnano: x1 [value] is a norm/average in property/amount x2 (ka/ni) among x3(s) (set) by standard x4
condi: x1 is deep in extent in direction/property x2 away from reference point x3 by standard x4
frati: x1 reacts/responds/answers with action x2 to stimulus x3 under conditions x4; x1 is responsive
tinsa: x1 is stiff/rigid/inflexible/resistant in direction x2 against force x3 under conditions x4
tagji: x1 is snug/tight on x2 in dimension/direction x3 at locus x4
slabu: x1 is old/familiar/well-known to observer x2 in feature x3 (ka) by standard x4
caxno: x1 is shallow in extent in direction/property x2 away from reference point x3 by standard x4
cerda: x1 is an heir to/is to inherit x2 (object/quality) from x3 according to rule x4
cokcu: x1 soaks up/absorbs/sucks up x2 from x3 into x4; x1 is an absorbant





















## . reflect ethos .
crida: x1 is a fairy/elf/gnome/brownie/pixie/goblin/kobold [mythical humanoid] of mythos/religion x2
natmi: x1 is a nation/ethnic group of peoples x2; [people sharing a history/culture]
kulnu: x1 [mass of ideas, customs, skills, arts] is culture of nation/ethos x2 (mass); x1 is ethnic
cecmu: x1 is a community/colony of organisms x2

baxso: x1 reflects Malay-Indonesian common language/culture in aspect x2
bemro: x1 reflects North American culture/nationality/geography in aspect x2
bengo: x1 reflects Bengali/Bangladesh culture/nationality/language in aspect x2
brazo: x1 reflects Brazilian culture/nationality/language in aspect x2
brito: x1 reflects British/United Kingdom culture/nationality in aspect x2
budjo: x1 pertains to the Buddhist culture/religion/ethos in aspect x2
dadjo: x1 pertains to the Taoist culture/ethos/religion in aspect x2
dotco: x1 reflects German/Germanic culture/nationality/language in aspect x2
dzipo: x1 reflects Antarctican culture/nationality/geography in aspect x2
filso: x1 reflects Palestinian culture/nationality in aspect x2
fraso: x1 reflects French/Gallic culture/nationality/language in aspect x2
friko: x1 reflects African culture/nationality/geography in aspect x2
gento: x1 reflects Argentinian culture/nationality in aspect x2
glico: x1 is English/pertains to English-speaking culture in aspect x2
jegvo: x1 pertains to the common Judeo-Christian-Muslim culture/religion/nationality in aspect x2
jerxo: x1 reflects Algerian culture/nationality in aspect x2
jordo: x1 reflects Jordanian culture/nationality in aspect x2
jungo: x1 reflects Chinese [Mandarin, Cantonese, Wu, etc.] culture/nationality/language in aspect x2
kadno: x1 reflects Canadian culture/nationality in aspect x2
ketco: x1 reflects South American culture/nationality/geography in aspect x2
kisto: x1 reflects Pakistani/Pashto culture/nationality/language in aspect x2
latmo: x1 reflects Latin/Roman/Romance culture/empire/language in aspect x2
libjo: x1 reflects Libyan culture/nationality in aspect x2
lojbo: x1 reflects [Loglandic]/Lojbanic language/culture/nationality/community in aspect x2
lubno: x1 reflects Lebanese culture/nationality in aspect x2
meljo: x1 reflects Malaysian/Malay culture/nationality/language in aspect x2
merko: x1 pertains to USA/American culture/nationality/dialect in aspect x2
mexno: x1 reflects Mexican culture/nationality in aspect x2
misro: x1 reflects Egyptian culture/nationality in aspect x2
morko: x1 reflects Moroccan culture/nationality in aspect x2
muslo: x1 pertains to the Islamic/Moslem/Koranic [Quranic] culture/religion/nation in aspect x2
polno: x1 reflects Polynesian/Oceanian (geographic region) culture/nationality/languages in aspect x2
ponjo: x1 reflects Japanese culture/nationality/language in aspect x2
porto: x1 reflects Portuguese culture/nationality/language in aspect x2
rakso: x1 reflects Iraqi culture/nationality in aspect x2
ropno: x1 reflects European culture/nationality/geography/Indo-European languages in aspect x2
rusko: x1 reflects Russian culture/nationality/language in aspect x2
sadjo: x1 reflects Saudi Arabian culture/nationality in aspect x2
semto: x1 reflects Semitic [metaphor: Middle-Eastern] language/culture/nationality in aspect x2
sirxo: x1 reflects Syrian culture/nationality in aspect x2
skoto: x1 reflects Gaelic/Scottish culture/nationality/language in aspect x2
slovo: x1 reflects Slavic language/culture/ethos in aspect x2
softo: x1 reflects Russian empire/USSR/ex-USSR/CIS culture/nationality in aspect x2
spano: x1 reflects Spanish-speaking culture/nationality/language in aspect x2
sralo: x1 reflects Australian culture/nationality/geography/dialect in aspect x2
srito: x1 reflects Sanskrit language/Sanskritic/Vedic culture/nationality in aspect x2
vukro: x1 reflects Ukrainian language/culture/nationality in aspect x2
xazdo: x1 reflects Asiatic culture/nationality/geography in aspect x2
xebro: x1 reflects Hebrew/Jewish/Israeli culture/nationality/language in aspect x2
xelso: x1 reflects Greek/Hellenic culture/nationality/language in aspect x2
xindo: x1 reflects Hindi language/culture/religion in aspect x2
xispo: x1 reflects Hispano-American culture/nationalities in aspect x2
xrabo: x1 reflects Arabic-speaking culture/nationality in aspect x2
xriso: x1 pertains to the Christian religion/culture/nationality in aspect x2
xurdo: x1 reflects Urdu language/culture/nationality in aspect x2


## . is 1.0**n of . dimension .
gocti: x1 is 1x10**-24 of x2 in dimension/aspect x3 (default is units)
zepti: x1 is 1x10**-21 of x2 in dimension/aspect x3 (default is units)
xatsi: x1 is 1x10**-18 of x2 in dimension/aspect x3 (default is units)
femti: x1 is 1x10**-15 of x2 in dimension/aspect x3 (default is units)
picti: x1 is a trillionth [1x10**-12] of x2 in dimension/aspect x3 (default is units)
nanvi: x1 is a billionth/thousand-millionth [1x10**-9] of x2 in dimension/aspect x3 (default is units)
mikri: x1 is a millionth [1x10**-6] of x2 in dimension/aspect x3 (default is units)
milti: x1 is a thousandth [1/1000; 1x10**-3] of x2 in dimension/aspect x3 (default is units)
centi: x1 is a hundredth [1/100; 1x10**-2] of x2 in dimension/aspect x3 (default is units)
decti: x1 is a tenth [1/10; 1x10**-1] of x2 in dimension/aspect x3 (default is units)
(nulpa)
dekto: x1 is ten [10; 1*10**1] of x2 in dimension/aspect x3 (default is units)
xecto: x1 is a hundred [100; 1x10**2] of x2 in dimension/aspect x3 (default is units)
kilto: x1 is a thousand [1000; 1x10**3] of x2 in dimension/aspect x3 (default is units)
megdo: x1 is a million [1x10**6] of x2 in dimension/aspect x3 (default is units)
gigdo: x1 is a billion [British milliard] [1x10**9] of x2 in dimension/aspect x3 (default is units)
terto: x1 is a trillion [1x10**12] of x2 in dimension/aspect x3 (default is units)
petso: x1 is 1x10**15 of x2 in dimension/aspect x3 (default is units)
xexso: x1 is 1x10**18 of x2 in dimension/aspect x3 (default is units)
zetro: x1 is 1x10**21 of x2 in dimension/aspect x3 (default is units)
gotro: x1 is 1x10**24 of x2 in dimension/aspect x3 (default is units)


## . is partof body/entity . ⟦ix.egular⟧
rango: x1 is a/the body organ [body-part] of body/species x2 performing function x3
cidni: x1 is a/the knee/elbow/knuckle [hinged joint, body-part] of limb x2 of body x3
cinza: x1 is a/are tong(s)/chopsticks/pincers/tweezers/pliers [tool/body-part] for x2 to pinch x3
degji: x1 is a/the finger/digit/toe [body-part] on limb/body site x2 of body x3; [metaphor: peninsula]
cigla: x1 is a/the gland [body-part] secreting x2, of body x3; x2 is a secretion of x1
bongu: x1 is a/the bone/ivory [body-part], performing function x2 in body of x3; [metaphor: calcium]
ctebi: x1 is a/the lip [body-part]/rim of orifice x2 of body x3; (adjective:) x1 is labial
ganti: x1 is a/the testes/ovary/testicle/scrotum/balls/gonad/stamen/pistil [body-part] of x2, gender x3
janco: x1 is a/the shoulder/hip/joint [body-part] attaching limb/extremity x2 to body x3
kerfa: x1 is a/the hair/fur [body-part] of x2 at body location x3
narge: x1 is a nut [body-part: hard-shelled fruit] from plant/species x2 with shell x3 and kernel x4
nazbi: x1 is the nose [body-part] of x2 with nostril(s)/nasal passage(s) x3; [metaphor: protrusion]
xasne: x1 is a/the sweat/perspiration from body x2, excreted by gland(s)/organs x3
tamji: x1 is a/the thumb/big toe [body-part] on limb x2 of x3; [metaphor based on relative shape]
sluji: x1 is a/the muscle [body-part] controlling x2, of body x3; [metaphor: tools of physical power]
tsiju: x1(s) is/are (a) seed(s)/spore(s) [body-part] of organism x2 for producing offspring x3

balji: x1 is a bulb [body-part] of plant/species x2; [metaphor: rounded, bulgy]
besna: x1 is a/the brain [body-part] of x2; [metaphor: intelligence, mental control]
betfu: x1 is a/the abdomen/belly/lower trunk [body-part] of x2; [metaphor: midsection]
bidju: x1 is a bead/pebble [shape/form] of material x2
birka: x1 is a/the arm [body-part] of x2; [metaphor: branch with strength]
canti: x1 is a/the gut(s)/entrails/intestines/viscera/innards/digestive system [body-part] of x2
cnebo: x1 is a/the neck [body-part] of x2; [metaphor: a relatively narrow point]
denci: x1 is a/the tooth [body-part] of x2
zargu: x1 is a/the buttock(s)/arse/rear/seat [body-part] of x2; [metaphor: rounded surface, support]
xedja: x1 is a/the jaw [body-part] of x2
xance: x1 is a/the hand [body-part] of x2; [metaphor: manipulating tool, waldo]
xadni: x1 is a/the body/corpus/corpse of x2; (adjective:) x1 is corporal/corporeal
vlagi: x1 is a/the vulva [body-part] of x2
vibna: x1 is a/the vagina [body-part] of x2
tuple: x1 is a/the leg [body-part] of x2; [metaphor: supporting branch]
tatru: x1 is a/the breast/mammary/teat [body-part] of x2; [metaphor: projection providing liquid]
tance: x1 is a/the tongue [body-part] of x2; (metaphor: similar to nazbi, tamji, degji)
sufti: x1 is a/the hoof [body-part] of x2
stedu: x1 is a/the head [body-part] of x2; [metaphor: uppermost portion]
stani: x1 is a/the stalk/stem/trunk [body-part] of plant/species x2; [metaphor: main support]
skapi: x1 is a pelt/skin/hide/leather from x2
risna: x1 is a/the heart [body-part] of x2; [emotional/shape metaphors are NOT culturally neutral]
rebla: x1 is a/the tail/appendix [body-part] of x2; [metaphor: trailing, following portion/appendage]
jamfu: x1 is a/the foot [body-part] of x2; [metaphor: lowest portion] (adjective:) x1 is pedal
plibu: x1 is a/the pubic area/external genitalia [body-part] of x2
pinji: x1 is a/the clitoris/penis [projecting reproductive organ; body-part] of x2
pimlu: x1 is a/the feather/plume(s)/plumage [body-part] of animal/species x2
nalci: x1 is a/the wing [body-part] of x2; [metaphor: lateral supporting surface]
nirna: x1 is a nerve/neuron [body-part] of x2; [metaphor: information/control network connection]
pilka: x1 is a crust/rind/peel/skin/hide/outer cover of x2
pezli: x1 is a leaf of plant x2; x1 is foliage of x2
moklu: x1 is a/the mouth/oral cavity [body-part] of x2; (metaphor: entrance/intake for consumption)
mebri: x1 is a/the brow/forehead [projecting flat/smooth head/body-part] of x2
livga: x1 is a/the liver [body-part] of x2
kerlo: x1 is a/the ear [body-part] of x2; [metaphor: sensory apparatus, information gathering]
menli: x1 is a mind/intellect/psyche/mentality/[consciousness] of body x2
kanla: x1 is a/the eye [body-part] of x2; [metaphor: sensory apparatus]; (adjective:) x1 is ocular
jirna: x1 is a/the horn [body-part] of x2; [metaphor: pointed extremity]
jimca: x1 is a branch/bough/limb of x2; x2 forks into branches x1; [preferred over metaphorical birka]
jgalu: x1 is a/the claw/nail/talon [body-part] of x2; [metaphor: pointed, penetrating, physical weapon
gutra: x1 is a/the womb/uterus [body-part] of x2; [metaphor: nourishing, protective, giving birth]
ganxo: x1 is a/the anus/anal orifice/asshole/arsehole [body-part] of x2; [metaphor: exit, waste exit]
galxe: x1 is a/the throat/gullet [body-part] of x2; [metaphor: narrow(ing) opening of a deep hole]
flira: x1 is a/the face [head/body-part] of x2; (adjective:) x1 is facial
fepri: x1 is a/the lung [body-part] of x2; [metaphor: breathing/respiratory apparatus/bellows]
genja: x1 is a root [body-part] of plant/species x2; [metaphor: immobile, supporting, nourishing]

kenra: x1 is a cancer [malignant disease] in x2
pinca: x1 is a/the urine/piss/pee of x2
kalci: x1 is a/the feces/excrement/dung/shit of x2 (animal/person); (adjective:) x1 is fecal (matter)
rectu: x1 is a quantity of/contains meat/flesh from source/animal x2
sovda: x1 is an egg/ovum/sperm/pollen/gamete of/from organism [mother/father] x2
ciblu: x1 is blood/vital fluid of organism x2

drudi: x1 is a roof/top/ceiling/lid of x2
balni: x1 is a balcony/overhang/ledge/shelf of building/structure x2
balre: x1 is a blade of tool/weapon x2
jicmu: x1 is a basis/foundation/underlying or fundamental principle of x2; x1 is at the bottom of x2
&cifnu

## . is specy of breed .
jutsi: x1 is a species of genus x2, family x3, etc.; [open-ended tree-structure categorization]
jgina: x1 is a gene of creature [or locus on creature] x2 determining trait/process x3
&cifnu

### plants
latna: x1 is a lotus, plant/flower/herb of species/strain x2 symbolizing x3 to culture/religion x4
ckunu: x1 is a conifer/pine/fir of species/strain x2 with cones x3

cunmi: x1 is a quantity of millet [grain] of species/strain x2
cindu: x1 is an oak, a type of tree of species/strain x2
badna: x1 is a banana/plantain [fruit/plant] of species/breed x2
cakla: x1 is made of/contains/is a quantity of chocolate/cocoa
dembi: x1 is a bean/pea/leguminous seed from plant [legume] x2
tricu: x1 is a tree of species/cultivar x2
zumri: x1 is a quantity of maize/corn [grain] of species/strain x2 
xrula: x1 is a/the flower/blossom/bloom [body-part] of plant/species x2; (adjective:) x1 is floral
xruba: x1 is a quantity of buckwheat/rhubarb/sorrel grass of species/strain x2
sluni: x1 is a quantity of/contains onions/scallions of type/cultivar x2
tujli: x1 is a tulip (defined by flower shape) of species/strain x2
spati: x1 is a plant/herb/greenery of species/strain/cultivar x2
sorgu: x1 is a quantity of sorghum of species/strain x2
sobde: x1 is a quantity of soya [grain/bean] of species/strain x2
tcati: x1 is made of/contains/is a quantity of tea brewed from leaves x2
tanko: x1 is a quantity of tobacco [leaf] of species/strain x2
tamca: x1 is a tomato [fruit/vegetable/plant] of species/strain x2
sunga: x1 is a quantity of garlic [bulb] of species/strain x2
stagi: x1 is the edible x2 portion of plant x3; x1 is a vegetable
srasu: x1 is a blade/expanse of grass of species x2
samcu: x1 is a quantity of cassava/taro/manioc/tapioca/yam [edible starchy root] of species/strain x2
rozgu: x1 is a rose [flower - characterized by prickly stem/fragrance] of species/strain x2
rismi: x1 is a quantity of rice [a type of grain] of strain/cultivar x2
plise: x1 is an apple [fruit] of species/strain x2
jbari: x1 is a berry (fruit/plant) of plant/species x2
perli: x1 is a pear [fruit] of species/strain x2
patlu: x1 is a potato [an edible tuber] of variety/cultivar x2
nimre: x1 is a quantity of citrus [fruit/tree, etc.] of species/strain x2
mudri: x1 is a quantity of/is made of/contains wood/lumber from tree(s) of type/species x2
mraji: x1 is a quantity of rye [grain] of species/strain x2
maxri: x1 is a quantity of wheat [grain] of species/strain x2
mavji: x1 is a quantity of oats [grain] of species/strain x2
marna: x1 is a quantity of hemp/marijuana/jute of species/strain x2
mapni: x1 is a quantity of/contains/is made of cotton [type of fabric/material]
korka: x1 is a quantity of/contains/is made of cork/bark from tree/species x2; [material]
kobli: x1 is a quantity of cabbage/lettuce/leafy vegetable of species/strain x2
grute: x1 is a fruit [body-part] of species x2
figre: x1 is a fig [fruit/tree] of species/strain x2
guzme: x1 is a melon/squash [fruit/plant] of species/strain x2
gurni: x1 is grain/[British: corn]/cereal from plant/species x2

### animals
tirxu: x1 is a tiger/leopard/jaguar/[tigress] of species/breed x2 with coat markings x3
lanme: x1 is a sheep/[lamb/ewe/ram] of species/breed x2 of flock x3
remna: x1 is a human/human being/man (non-specific gender-free sense); (adjective:) x1 is human

cribe: x1 is a bear/ursoid of species/breed x2
cipni: x1 is a bird/avian/fowl of species x2
cinfo: x1 is a lion/[lioness] of species/breed x2
danlu: x1 is an animal/creature of species x2; x1 is biologically animate
datka: x1 is a duck/[drake] of species/breed x2
bakni: x1 is a cow/cattle/kine/ox/[bull/steer/calf] [beef-producer/bovine] of species/breed x2
banfi: x1 is an amphibian of species/breed x2
mabru: x1 is a mammal/'animal'/beast of species x2
lorxu: x1 is a fox [bushy-tailed wild dog/canine] of species/breed x2
labno: x1 is a wolf/lupine of species/breed x2
kumte: x1 is a camel/llama/alpaca/vicuna/dromedary of species/breed x2
mlatu: x1 is a cat/[puss/pussy/kitten] [feline animal] of species/breed x2; (adjective:) x1 is feline
mirli: x1 is a deer/elk/moose/[hart/stag/doe] of species/breed x2
kanba: x1 is a goat/angora/[billy-goat/kid] of species/breed x2
xruki: x1 is a turkey [food/bird] of species/breed x2
xirma: x1 is a horse/equine/[colt/mare/stallion/pony] of species/breed x2
xasli: x1 is a donkey/jackass of species/breed x2
xarju: x1 is a pig/hog/swine/[boar] [pork/ham/bacon-producer] of species/breed x2
xanto: x1 is an elephant of species/breed x2
smani: x1 is a monkey/ape/simian/baboon/chimpanzee of species/breed x2
smacu: x1 is a mouse of species/breed x2
since: x1 is a snake/serpent of species/breed x2
respa: x1 is a reptile of species/breed x2
ratcu: x1 is a rat of species/breed x2
ractu: x1 is a rabbit/hare/[doe] of species/breed x2
jipci: x1 is a chicken/[hen/cock/rooster]/small fowl [a type of bird] of species/breed x2
gunse: x1 is a goose/[gander] of species/breed x2
gerku: x1 is a dog/canine/[bitch] of species/breed x2
finpe: x1 is a fish of species x2 [metaphorical extension to sharks, non-fish aquatic vertebrates]

### music instruments
xagri: x1 is a oboe/clarinet/saxophone [reed musical instrument] with reed x2
jgita: x1 is guitar/violin/fiddle/harp [stringed musical instrument] with actuator/plectrum/bow x2

tabra: x1 is a horn/trumpet/trombone/bugle [brass-wind/lip-reed musical instrument]
pipno: x1 is a piano/harpsichord/synthesizer/organ; a keyboard musical instrument
flani: x1 is a flute/pipe/fife/recorder [flute-like/air-reed musical instrument]

### insects and associated, misc
clika: x1 is a moss/lichen of species/strain x2 growing on x3
vidru: x1 is a virus of species/breed/defining property x2 capable of infecting [at] x3
civla: x1 is a louse/flea [blood-sucking arthropod] of species/breed x2, parasitic on x3
mledi: x1 is a mold/fungus/mushrooms/truffles of species/strain x2 parasitic/growing on x3

toldi: x1 is a butterfly/moth of species/breed x2
sfani: x1 is a fly [a small non-stinging flying insect] of species/breed x2
manti: x1 is an ant of species/breed x2
jalra: x1 is a cockroach/[orthopteran/termite] of order/species/breed x2
jukni: x1 is a spider/arachnid/[crustacean/crab/lobster/non-insect arthropod] of species/breed x2
curnu: x1 is a worm/invertebrate animal of species/breed x2
cinki: x1 is an insect/arthropod of species x2; [bug/beetle]
bifce: x1 is a bee/wasp/hornet of species/breed x2
jurme: x1 is a bacteria/germ/microbe/protozoan/amoeba [1-celled life] of species/defining property x2


## geometrical forms
kruca: x1 intersects/crosses/traverses x2 at locus x3
midju: x1 is in/at the middle/center/midpoint/[is a focus] of x2; (adjective:) x1 is central

mokca: x1 is a point/instant/moment [0-dimensional shape/form] in/on/at time/place x2
linji: x1 is a line/among lines [1-dimensional shape/form] defined by set of points x2
plita: x1 is a plane [2-dimensional shape/form] defined by points x2 (set); x1 is flat/[smooth]
canlu: x1 is space/volume/region/room [at-least-3-dimensional area] occupied by x2
jganu: x1 is an angle [2-dimensional shape/form] from vertex x2 subtended by lateral [segment] x3
kevna: x1 is a cavity/hole/hollow/cavern in x2; x1 is concave within x2; x2 is hollow at locus x1
korbi: x1 is an edge/margin/border/curb/boundary of x2 next-to/bordering-on x3
jipno: x1 is a tip/point/vertex/extremity [0-dimension shape/form] on object x2 at locus x3
jimte: x1 is a limit/extreme/bound/border/[confinement] of x2 in property/domain x3
sefta: x1 is surface/face [bounded shape/form] of [higher-dimension] object x2, on side x3, edges x4
panlo: x1 is a slice [thin flat portion] of x2 (mass)
kurfa: x1 is a right-angled shape/form defined by set of vertices x2, dimensions x3 (default 2)
kubli: x1 is a cube/regular polyhedron/polygon of dimensions x2 (def. 3), surfaces/sides x3 (def. 6)
kruvi: x1 is a curve/turn/bend in x2, at locus x3, and defined by set of points/properties x4
jgena: x1 is a knot/tangle in/between x2 (object/jo'u-objects)
skuro: x1 is a groove/trench/furrow [shape/form] in object/surface x2
sirji: x1 is straight/direct/line segment/interval between x2 and x3; (adjective:) x1 is linear
snuji: x1 is a sandwich/layering [not restricted to food] of x2 sandwiched between x3
sarlu: x1 is a spiral/helix/whorl/[vortex] [shape/form] with limits x2, of dimensionality x3 ⟦AND WHY NO FUNCTION SLOT??⟧
bliku: x1 is a block [3-dimensional shape/form] of material x2, surfaces/sides x3

⁓⁓⁓ sb . material .
bolci: x1 is a ball/sphere/orb/globe [shape/form] of material x2; x1 is a spherical object [made of x2]
tanbo: x1 is a board/plank [3-dimensional long flat rectangle] of material x2
slanu: x1 is a cylinder [shape/form] of material x2

⁓⁓⁓ sb . material . .
tubnu: x1 is a length of tubing/pipe/hollow cylinder [shape/form] of material x2, hollow of material x3

⁓⁓⁓ sb . locus . material
kojna: x1 is a corner/point/at-least-3-dimensional [solid] angle [shape/form] in/on x2, of material x3
punli: x1 is a swelling/protrusion/convexity [shape/form] at/in/on x2, of material x3

⁓⁓⁓ sb . material . ka .
konju: x1 is a cone [shape/form] of material x2 with vertex x3

⁓⁓⁓ sb . material . ka . .
tapla: x1 is a tile/cake [shape/form] of material x2, shape x3, thickness x4
djine: x1 is a ring/annulus/torus/circle [shape/form] of material x2, inside diam. x3, outside diam. x4

⁓⁓⁓ sb . use . composition .
tanxe: x1 is a box/carton/trunk/crate for contents x2, and made of material x3
tansi: x1 is a pan/basin/tub/sink, a shallow container for contents x2, of material/properties x3
cutci: x1 is a shoe/boot/sandal for covering/protecting [feet/hooves] x2, and of material x3

⁓⁓⁓ sb . locus . composition
barna: x1(s) is a/are mark(s)/spot(s) on x2 of material x3

## language organization
rafsi: x1 is an affix/suffix/prefix/combining-form for word/concept x2, form/properties x3, language x4
valsi: x1 is a word meaning/causing x2 in language x3; (adjective: x1 is lexical/verbal)
jufra: x1 (text) is a sentence/statement about x2 [topic/subject/predicate/focus] in language x3
gerna: x1 is the grammar/rules/defining form of language x2 for structure/text x3
gismu: x1 is a (Lojban) root word expressing relation x2 among argument roles x3, with affix(es) x4
lujvo: x1 (text) is a compound predicate word with meaning x2 and arguments x3 built from metaphor x4
tanru: x1 is a binary metaphor formed with x2 modifying x3, giving meaning x4 in language x5
cmavo: x1 is a structure word of grammatical class x2, with meaning/function x3 in language x4
gadri: x1 is an article/descriptor labelling description x2 (text) in language x3 with semantics x4
sumti: x1 is a/the argument of predicate/function x2 filling place x3 (kind/number)
bridi: x1 (text) is a predicate relationship with relation x2 among arguments (sequence/set) x3
smuni: x1 is a meaning/interpretation of x2 recognized/seen/accepted by x3
sinxa: x1 is a sign/symbol/signal representing/referring/signifying/meaning x2 to observer x3
slaka: x1 is a syllable in language x2
lerfu: x1 (la'e zo BY/word-bu) is a letter/digit/symbol in alphabet/character-set x2 representing x3
cmene: x1 (quoted word(s)) is a/the name/title/tag of x2 to/used-by namer/name-user x3 (person)


## . is season of year . location .
citsi: x1 is a season/is seasonal [cyclical interval], defined by interval/property x2, of year(s) x3

vensa: x1 is spring/springtime [warming season] of year x2 at location x3; (adjective:) x1 is vernal
critu: x1 is autumn/fall [harvest/cooling season] of year x2 at location x3
crisa: x1 is summer/summertime [hot season] of year x2 at location x3
dunra: x1 is winter/wintertime [cold season] of year x2 at location x3


## . is moment of day . location .
detri: x1 is the date [day,{week},{month},year] of event/state x2, at location x3, by calendar x4
tcika: x1 [hours, {minutes}, {seconds}] is the time/hour of state/event x2 on day x3 at location x4

murse: x1 is the [astronomical] twilight/dawn/dusk/half-light/glimmering of day x2 at location x3
cerni: x1 is a morning [dawn until after typical start-of-work for locale] of day x2 at location x3
vanci: x1 is an evening [from end-of-work until sleep typical for locale] of day x2 at location x3

donri: x1 is the daytime of day x2 at location x3; (adjective:) x1 is diurnal (vs. nocturnal)
nicte: x1 is a nighttime of day x2 at location x3; (adjective:) x1 is at night/nocturnal
